Working memory in healthy and schizophrenic individuals	皓宇
Concrete Permuted Rule Operations	皓宇
MASiVar: Multisite, Multiscanner, and Multisubject Acquisitions for Studying Variability in Diffusion Weighted Magnetic Resonance Imaging	皓宇
MASiVar: Multisite, Multiscanner, and Multisubject Acquisitions for Studying Variability in Diffusion Weighted Magnetic Resonance Imaging	皓宇
The heterogeneity in retrieved relations between the personality trait 'Harm avoidance' and gray matter volumes due to variations in the VBM and ROI labeling processing settings	皓宇
The heterogeneity in retrieved relations between the personality trait 'Harm avoidance' and gray matter volumes due to variations in the VBM and ROI labeling processing settings	皓宇
Dynamic_Passive_Threat	皓宇
Exploring the Resting State Neural Activity of Monolinguals and Late and Early Bilinguals	皓宇
Public Lung Database To Address Drug Response	皓宇
TCGA-COAD	皓宇
AOMIC-ID1000	皓宇
Cross-Sectional Multidomain Lexical Processing	皓宇
Developmental change in prefrontal cortex recruitment supports the emergence of value-guided memory	皓宇
Multi-echo Cambridge	皓宇
RSNA Intracranial Hemorrhage Detection	皓宇
Cortical myelin measured by the T1w/T2w ratio in individuals with depressive disorders and healthy controls	皓宇
ACNS0332	皓宇
Naturalistic Neuroimaging Database	皓宇
The Stockholm Sleepy Brain Study: Effects of Sleep Deprivation on Cognitive and Emotional Processing in Young and Old	皓宇
AIBL	皓宇
TCGA-OV	皓宇
Emotion regulation in the Ageing Brain, University of Reading, BBSRC	皓宇
Speech disfluencies: Neurophysiological aspect in normal population	皓宇
Speech disfluencies: Neurophysiological aspect in normal population	皓宇
rsfMRI_comrobidity-SmokingandSchizophrenia	皓宇
ACRIN-DSC-MR-Brain (ACRIN 6677/RTOG 0625)	运成
Pediatric-CT-SEG	运成
MIRIAD dataset	运成
Cam-CAN	运成
Prostate-3T	运成
TCGA-LUAD	运成
Soft-tissue-Sarcoma	运成
LDCT-and-Projection-data	运成
IXI Dataset	运成
ADRC(ABVIB)	运成
TCGA-GBM	运成
QIN-Breast	运成
VOLCANO'09	运成
CPTAC-HNSCC	运成
SMIR Full Body CT	运成
ELCAP Public Lung Image Database	运成
Lausanne_TOF-MRA_Aneurysm_Cohort	运成
Head-Neck-Radiomics-HN1	运成
LGG-1p19qDeletion	运成
ACRIN-FMISO-Brain (ACRIN 6684)	运成
OASIS-1	运成
TCGA-CESC	运成
ALLOP1	运成
QIN-HeadNeck	运成
OASIS-2	运成
Prostate-Diagnosis	子炎
QIN-BRAIN-DSC-MRI	子炎
Narratives	子炎
ACRIN 6685	子炎
A longitudinal neuroimaging dataset on language processing in children ages 5, 7, and 9 years old	子炎
MPI-Leipzig_Mind-Brain-Body	子炎
ADNIDOD	子炎
Brain Segmentation Testing Protocol	子炎
COMPUTATIONAL CHALLENGES ON SPINE IMAGING	子炎
TCGA-STAD	子炎
Neurocognitive aging data release with behavioral, structural, and multi-echo functional MRI measures	涂璨
Mandibular CT Dataset Collection	涂璨
OASIS-3	涂璨
Prostate-MRI-US-Biopsy	涂璨
Structural (t1) images of 136 young healthy adults; study of effects of chronotype, sleep quality and daytime sleepiness on brain structure	涂璨
UCLA Consortium for Neuropsychiatric Phenomics LA5c Study	涂璨
Head-Neck-PET-CT	涂璨
ADNID	涂璨
Mouse_rest_multicentre	涂璨
xVertSeg	涂璨
TCGA-LGG	涂璨
Colin 3T/7T High-resolution Atlas	涂璨
PPMI	涂璨
The human Voice Areas: spatial organisation and inter-individual variability in temporal and extra-temporal cortices	涂璨
NSCLC-Cetuximab (RTOG-0617)	涂璨
AHEP0731	涂璨
Multi-Modality Vertebra Recognition in Arbitrary Views using 3D Deformab le Hierarchical 	涂璨
TCGA-HNSC	涂璨
CALGB50303	涂璨
Vestibular-Schwannoma-SEG	涂璨
GLIS-RT	涂璨
GLIS-RT	涂璨
TCGA-BRCA	涂璨
Anti-PD-1_MELANOMA	涂璨
CPTAC-GBM	涂璨
High anisotropy MRIs of the lower back	涂璨
Head-Neck Cetuximab (RTOG 0522)	涂璨
GSP	镜淇
SUDMEX_CONN: The Mexican dataset of cocaine use disorder patients.	镜淇
SUDMEX_CONN: The Mexican dataset of cocaine use disorder patients.	镜淇
BrainMetShare	镜淇
MRI data of 3-12 year old children and adults during viewing of a short animated film	镜淇
PETfrog	镜淇
REMBRANDT	镜淇
BOLD Verb Generation	镜淇
Pragmatic Language	镜淇
MRI data during a Cue Induced Craving task following food fasting, social isolation and baseline (within-subject design)	镜淇
SerumGreyMatterCorticalThickness	镜淇
MRNet	镜淇
White matter deficits in cocaine use disorder V1.0	镜淇
Brain Correlates of Math Development	镜淇
CAMRI Rat Brain MRI Data	镜淇
Cognitive Training	镜淇
HNSCC	镜淇
NARPS	镜淇
OPC-Radiomics	镜淇
AREN0534	镜淇
Washington University 120	镜淇
Caltech Conte Center - A multimodal data resource for exploring social cognition and decision-making.	镜淇
Pelvic-Reference-Data	镜淇
HEAR-EU	镜淇
HCP	镜淇
AAPM RT-MAC Grand Challenge 2019	镜淇
TCGA-BLCA	镜淇
COVID19-CT-1000	镜淇
1000 Functional Connectomes Project	镜淇
DeepLesion	镜淇